222222222222222222222222222222222
200000001000000000010000100000001
200000000000000000000000000000001
200001000000000000100000000000001
200000000000000000000000000000001
200000000000000000000000000000001
200000000000100000000000000000001
200000000000000000000100000000001
200010000000000000000000000000001
200000000000000000000000000000001
200000000000000000000000000000001
200000011111111111100000000010001
200000000000000000100000000000001
200000011111111110100000001000001
200000000000000000100000000000001
200000001111111111100000010000001
200000000000000000000000000000001
200000000000000000000000000000001
211111111111111111111111111111111
