111111111111111111111111111111111
100000000000000000000000000000001
100000010000000000000010000000001
100000000000000000000000000000001
100000000000000000000000000000001
100000000000000000000000000000001
100000000000000000000000000000001
100000000000000000000000000000001
100000000000000000000000000000001
100000000000000000000000000000001
100000000000000000000000000000001
100000000000000000000000000000001
100000000000000000000000000000001
100000000000000000000000000000001
100001000000000000000000000000001
100000000000000000000000000000001
100100000000000000000100000000001
100000000000000000000000000000001
111111111111111111111111111111111
