222222222222222222222222222222222
200000001000000000010000100000003
200000000000000000000000000000003
200001000004000000100000000000003
200000000000000000000000000000003
200000000000000000000000000000003
200000040000100000000000000000003
200000000000000000000100000000003
200010000000000000000000000000003
200000000000000000000000000000003
200000000000000000000000000000003
200000044444444444400000000010003
200000000000000000100000000000003
200000011111111110100000001000003
200000000000000000100000000000003
200000001111111111100000010000003
200000000000000000000000000000003
200000000004000000000000000000001
211111111111111111111111111111111
