111111111111111111111111111111111111111111
100010000000010000000000000323344311113301
100010000000001000000000000200000000000401
100011111111001000000000000100000000400401
100000000001001000000000000114023100000401
100000000001001000000000000002003111111401
100000000001001110000000000004003000000001
100000000001100030000000000004003110000001
100000000000200031111122333332003010000001
100000000000200000050000000000000010000001
100000000000300023432200411112222110000001
100000000000400000000000400000000000000001
100000000000443221324000400000000000000001
100000000000000000004000400000000000000001
100000000000000000004000444444444400000001
100000000000000000004000000000000010000001
100000000000000000004333333333333310000001
100000000000000000000000000000000000000001
111111111111111111111111111111111111111111
