1111111111111111111111111111111111111111111111111111111111111111111
1000100000000100000000000003233443111133000000000000000000000000001
1000100000000010000000000002000000000004000000000000000000000000001
1000111111110010000000000001000000004004000000000000000000000000001
1000000000010010000000000001140231000004000000000000000000000000001
1000000000010010000000000000020031111114000000000000000000000000001
1000000000010011100000000000040030000000000000000000000000000000001
1000000000011000300000000000040031100000000000000000000000000000001
1000000000002000311111223333320030100000000000000000000000000000001
1000000000002000000000000000000000100000000000000000000000000000001
1000000000003000234322004111122221100000000000000000000000000000001
1000000000004000000000004000000000000000000000000000000000000000001
1000000000004432213240004000000000000000000000000000000000000000001
1000000000000000000040004000000000000000000000000000000000000000001
1000000000000000000040004444444444000000000000000000000000000000001
1000000000000000000040000000000000100000000000000000000000000000001
1000000000000000000043333333333333100000000000000000000000000000001
1000000000000000000000000000000000000000000000000000000000000000001
1111111111111111111111111111111111111111111111111111111111111111111
